|||||||||||||||||||||||||||||||||||||||||||||||||||||||||||||||||||||||||||||||||||||||||||||||||||||||||||||||||
|||||||C. . . . . . . . . . . . . . . . . . . . . . . . . . . . . . . . . . . . . . . . . . . . . . . . . *||||||
|||||||.|||||||||.||||||||||||||||||||||||||||||||||||||.||||||||||||||||||||||||||||||||||||||.||||||||||.||||||
|||||||.|||||||||.||||||||||||||||||||||||||||||||||||||.||||||||||||||||||||||||||||||||||||||.||||||||||.||||||
|||||||.|||||||||.|||||||||||||||||||*. . . . . . . . . . . . . . . . . . .*|||||||||||||||||||.||||||||||.||||||
|||||||.|||||||||.|||||||||||||||||||.||||||||||||||||||.||||||||||||||||||.|||||||||||||||||||.||||||||||.||||||
|||||||.|||||||||* . . . . . . . . . .||||||||||||||||||.||||||||||||||||||. . . . . . . . . . *||||||||||.||||||
|||||||.|||||||||||||||||||||||||||||.||||||||||||||||||.||||||||||||||||||.||||||||||||||||||||||||||||||.||||||
|||||||.|||||||||||||||||||||||||||||.||||||||||||||||||.||||||||||||||||||.||||||||||||||||||||||||||||||.||||||
|||||||.|||||||||||||||||||||||||||||.||||||||||||||||||.||||||||||||||||||.||||||||||||||||||||||||||||||.||||||
|||||||* . . . . . . . . . . . . . . . . . . . . . . . .*. . . . . . . . . . . . . . . . . . . . . . . . .*||||||
|||||||.||||||||||||||||||||||||.||||.||||||||||||||||||.||||||||||||||||||.||||||||||||||||||||||||||||||.||||||
|||||||.||||||||||||||||||||||||.||||.|||||||||||||||. ..||||||||||||||||||.||||||||||||||||||||||||||||||.||||||
|||||||. . . . . . * . . . ||||.|||||.|||||||||||||||.|||||||||||||||||||||.||||||||||||||||||||||||||||||.||||||
|||||||.|||||||||.||||||||.|||. . . . |||||||||||||||.|||||||||||||||||||||.||||||||||||||||||||||||||||||.||||||
|||||||.|||||||||.||||||||.|||.||||||||||||||||||. . .|||||||||||||||||||||. . .||||||||||||||||||||||||||.||||||
|||||||.|||||||||.||||||||. . .||||||||||||. . . .|||.|||||||||||||||||||||.||| . . . . . .. . .||||||||||.||||||
|||||||.|||||||||.|||||||||||||||||||*. . . . . . . . . . . . . . . . . . .*|||||||||||||||||||.||||||||||.||||||
|||||||.|||||||||.||||||||||||||||||||||||||||||||||||||.||||||||||||||||||||||||||||||||||||||.||||||||||.||||||
|||||||.|||||||||.||||||||||||||||||||||||||||||||||||||.||||||||||||||||||||||||||||||||||||||.||||||||||.||||||
|||||||*. . . . . . . . . . . . . . . . . . . . . . . . . . . . . . . . . . . . . . . . . . . . . . . . . *||||||
|||||||||||||||||||||||||||||||||||||||||||||||||||||||||||||||||||||||||||||||||||||||||||||||||||||||||||||||||