|||||||||||||||||||||||||||||||||||||||||||||
|||* . . . . . . . . . . . . . . . . . . *|||
|||.||||||||||||||||||.||||||||||||||||||.|||
|||.||||||||||||||||||.||||||||||||||||||.|||
|||* . . . . . . . . . . . . . . . . . . *|||
|||.|||||||||||||||||| ||||||||||||||||||.|||
|||.|||||||||||||||||| ||||||||||||||||||.|||
|||.|||||||||||A              |||||||||||.|||
|||.|||||||||||||||||||||||||||||||||||||.|||
|||.|||||||*. . . . . C . . . . .*|||||||.|||
|||.|||||||.||||||||||.||||||||||.|||||||.|||
|||.|||||||.||||||||||.||||||||||.|||||||.|||
|||.|||||||.||||||||||.||||||||||.|||||||.|||
|||.|||||||.||||||||||.||||||||||.|||||||.|||
|||* . . . *||||||||||.||||||||||* . . . *|||
|||.|||||||.||||||||||.||||||||||.|||||||.|||
|||.|||||||.||||||||||.||||||||||.|||||||.|||
|||.|||||||.||||||||||.||||||||||.|||||||.|||
|||* . . . * . . . . . . . . . . * . . . *|||
|||||||||||||||||||||||||||||||||||||||||||||

