|||||||||||||||||||||||||||||||||||||||||||||||||||||||||||||||||||||||||||||||||||||||||||||||||||||||||||||||||
|||||||C. . . . . . . . . . . . . . . . . . . . . . . . . . . . . . . . . . . . . . . . . . . . . . . . . *||||||
|||||||.|||||||||.||||||||||||||||||||||||||||||||||||||.||||||||||||||||||||||||||||||||||||||.||||||||||.||||||
|||||||.|||||||||.||||||||||||||||||||||||||||||||||||||.||||||||||||||||||||||||||||||||||||||.||||||||||.||||||
|||||||.|||||||||.|||||||||||||||||||*. . . . . . . . . . . . . . . . . . .*|||||||||||||||||||.||||||||||.||||||
|||||||.|||||||||.|||||||||||||||||||.||||||||||||||||||.||||||||||||||||||.|||||||||||||||||||.||||||||||.||||||
|||||||.|||||||||* . . . . . . . . . .||||||||||||||||||.||||||||||||||||||. . . . . . . . . . *||||||||||.||||||
|||||||.|||||||||||||||||||||||||||||.||||||||||||||||||.||||||||||||||||||.||||||||||||||||||||||||||||||.||||||
|||||||.|||||||||||||||||||||||||||||.||||||||||||||||||.||||||||||||||||||.||||||||||||||||||||||||||||||.||||||
|||||||.|||||||||||||||||||||||||||||.||||||||||||||||||.||||||||||||||||||.||||||||||||||||||||||||||||||.||||||
|||||||* . . . . . . . . . . . . . . . . . . . . . . . .*. . . . . . . . . . . . . . . . . . . . . . . . .*||||||
|||||||.|||||||||||||||||||||||||||||.||||||||||||||||||.||||||||||||||||||.||||||||||||||||||||||||||||||.||||||
|||||||.|||||||||||||||||||||||||||||.||||||||||||||||||.||||||||||||||||||.||||||||||||||||||||||||||||||.||||||
|||||||.|||||||||||||||||||||||||||||.|||||||||||A              |||||||||||.||||||||||||||||||||||||||||||.||||||
|||||||.|||||||||* . . . . . . . . . .||||||||||||||||||.||||||||||||||||||. . . . . . . . . . *||||||||||.||||||
|||||||.|||||||||.|||||||||||||||||||.||||||||||||||||||.||||||||||||||||||.|||||||||||||||||||.||||||||||.||||||
|||||||.|||||||||.|||||||||||||||||||*. . . . . . . . . . . . . . . . . . .*|||||||||||||||||||.||||||||||.||||||
|||||||.|||||||||.||||||||||||||||||||||||||||||||||||||.||||||||||||||||||||||||||||||||||||||.||||||||||.||||||
|||||||.|||||||||.||||||||||||||||||||||||||||||||||||||.||||||||||||||||||||||||||||||||||||||.||||||||||.||||||
|||||||*. . . . . . . . . . . . . . . . . . . . . . . . . . . . . . . . . . . . . . . . . . . . . . . . . *||||||
|||||||||||||||||||||||||||||||||||||||||||||||||||||||||||||||||||||||||||||||||||||||||||||||||||||||||||||||||

