|||||||||||||||||||||||||||||||||||||||||||||||||||||||||||||||||||||||||||||||||||||||||||||||||||||||||||||||||||||||||||||||
|||. . . . .|||||||. . . ||||||. . . . . . . . . . . . . . . . C . . . . . . . . . . . . . . . .||||||. . . .|||||||. . . . |||
|||.|||||||. . * . .||||.||||||.|||||||||||||||||||.|||||||||||||||||||||||.|||||||||||||||||||.||||||.|||||. . * . .||||||.|||
|||.|||||||||||.||||||||.|||. . |||||||||||||||||||.|||||||||||||||||||||||.||||||||||||||||||| . .|||.|||||||||.||||||||||.|||
|||.|||||||||||.||||||||.|||.||||||||||||||||||. . .|||||||||||||||||||||||. . .||||||||||||||||||.|||.|||||||||.||||||||||.|||
|||.|||||||||||.||||||||. . .||||||||||||. . . . ||.|||||||||||||||||||||||.||. . . .|||||||||||||. . .|||||||||.||||||||||.|||
|||.|||||||. . .||||||||||||.||||||||||||.|||||||||. . . . . . . . . . . . .||||||||.|||||||||||||.|||||||||||||. . |||||||.|||
|||.|||||||.||||||||||||||||.||||||||||||.|||||||||||||||||||||.||||||||||||||||||||.|||||||||||||.||||||||||||||||.|||||||.|||
|||. . . . .||||||||||||||||. . . *. . . .|||||||||||||||||||||.||||||||||||||||||||. . . * . . . .||||||||||||||||. . . . .|||
|||.||||||||||||||||||||||||||||||.||||||||||||||||||||||||||||.|||||||||||||||||||||||||||.|||||||||||||||||||||||||||||||.|||
|||. . . |||||||||||||||||||||||||.||||||||||||||||||||||||||||.|||||||||||||||||||||||||||.||||||||||||||||||||||||||. . . |||
|||.|||| .||||||||||||||||||||||||.||||||||||||||||||||||||||||.|||||||||||||||||||||||||||.|||||||||||||||||||||||||. ||||.|||
|||.|||||. . . . . . . . . . . . . ||||||||||||||||||||||||||||.|||||||||||||||||||||||||||. . . . . . . . . . . . . .|||||.|||
|||.|||||| .||||||||||||||||||||||.||||||||||||||. . . . ||||||.|||||||. . . . ||||||||||||.|||||||||||||||||||||||. ||||||.|||
|||.||||||| .|||||||||||||||||||||.|||||||||||||. ||||||. |||||.||||||. ||||||. |||||||||||.||||||||||||||||||||||. |||||||.|||
|||.|||||||| .||||||||||||||||||||.|||||||||||||.||||||||.|||||.||||||.||||||||.|||||||||||.|||||||||||||||||||||. ||||||||.|||
|||*. . . . . . . . . . . . . . . . . . . . . . . . . . . . . . . . . . . . . . . . . . . . . . . . . . . . . . . . . . . .*|||
|||.|||||||| .||||||||||||||||||||.|||||||||||||.||||||||.|||||.||||||.||||||||.|||||||||||.|||||||||||||||||||||. ||||||||.|||
|||.||||||| .|||||||||||||||||||||.|||||||||||||. ||||||. |||||.||||||. ||||||. |||||||||||.||||||||||||||||||||||. |||||||.|||
|||.|||||| .||||||||||||||||||||||.||||||||||||||. . . . ||||||.|||||||. . . . ||||||||||||.|||||||||||||||||||||||. ||||||.|||
|||.|||||. . . . . . . . . . . . . ||||||||||||||||||||||||||||.|||||||||||||||||||||||||||. . . . . . . . . . . . . .|||||.|||
|||.|||| .||||||||||||||||||||||||.||||||||||||||||||||||||||||.|||||||||||||||||||||||||||.|||||||||||||||||||||||||. ||||.|||
|||. . . |||||||||||||||||||||||||.||||||||||||||||||||||||||||.|||||||||||||||||||||||||||.||||||||||||||||||||||||||. . . |||
|||.||||||||||||||||||||||||||||||.||||||||||||||||||||||||||||.|||||||||||||||||||||||||||.|||||||||||||||||||||||||||||||.|||
|||. . . . .||||||||||||||||. . . *. . . .|||||||||||||||||||||.||||||||||||||||||||. . . * . . . .||||||||||||||||. . . . .|||
|||.|||||||.||||||||||||||||.||||||||||||.|||||||||||||||||||||.||||||||||||||||||||.|||||||||||||.||||||||||||||||.|||||||.|||
|||.|||||||. . .||||||||||||.||||||||||||.|||||||||. . . . . . . . . . . . .||||||||.|||||||||||||.|||||||||||||. . |||||||.|||
|||.|||||||||||.||||||||. . .||||||||||||. . . . ||.|||||||||||||||||||||||.||. . . .|||||||||||||. . .|||||||||.||||||||||.|||
|||.|||||||||||.||||||||.|||.||||||||||||||||||. . .|||||||||||||||||||||||. . .||||||||||||||||||.|||.|||||||||.||||||||||.|||
|||.|||||||||||.||||||||.|||. . |||||||||||||||||||.|||||||||||||||||||||||.||||||||||||||||||| . .|||.|||||||||.||||||||||.|||
|||.|||||||. . * . .||||.||||||.|||||||||||||||||||.|||||||||||||||||||||||.|||||||||||||||||||.||||||.|||||. . * . .||||||.|||
|||. . . . .|||||||. . . ||||||. . . . . . . . . . .  A                    . . . . . . . . . . .||||||. . . .|||||||. . . . |||
|||||||||||||||||||||||||||||||||||||||||||||||||||||||||||||||||||||||||||||||||||||||||||||||||||||||||||||||||||||||||||||||

