||||||||||||||||||||||||||||||||||||||||||||||||||||||||||||||||||||||||||||||||||||||||||||||||||||||||||||||||||||||||||||
||||||||||||||. . . . . . . . . .||||||||||||||||||||||||||||||||||||||||||||||||||||||||. . . . . . . . . . .||||||||||||||
||||||||||||||.|||||||||||||||||.||||||||||||||||||||||||||||||||||||||||||||||||||||||||.|||||||||||||||||||.||||||||||||||
||||||||||||||.|||||||||||||||||. . . . . . ||||||||||||||||||||||||||||||||||. . . . . . |||||||||||||||||||.||||||||||||||
|||||||||||. . . . . *||||||||||.||||||||||.||||||||||||||||||||||||||||||||||.||||||||||.|||||||||||*. . . . . .|||||||||||
|||||||||||.||||||||| ||||||||||.||||||||||.||||||||||||||.  C  .|||||||||||||.||||||||||.|||||||||||.||||||||||.|||||||||||
|||||||||||.|||||||||. . . . . . ||||||||||. . . . . . . . |||||. . . . . . . .||||||||||. . . . . . .||||||||||.|||||||||||
|||||||||||.|||||||||||||||||||||||||||||||.||||||||||||||.|||||.|||||||||||||.|||||||||||||||||||||||||||||||||.|||||||||||
|||||||||||. . . . . . . . . . . . . . . . *||||||||||||||.|||||.|||||||||||||*. . . . . . . . . . . . . . . . . |||||||||||
|||||||||||.|||||||||||||||||||||||||||||||.||||||||||||||.|||||.|||||||||||||.|||||||||||||||||||||||||||||||||.|||||||||||
|||||||||||.|||||||. . . . . . . .|||||||||.||||||||||||||.|||||.|||||||||||||.|||||||||. . . . . . . .|||||||||.|||||||||||
|||||||||||.|||||||.||||||||||||| |||||||||.||||||||||||||.|||||.|||||||||||||.||||||||| |||||||||||||.|||||||||.|||||||||||
|||||||||||.|||||||.|||||||||||||. . .  . . . . . . . . . .|||||. . .  . . . . . . . . . |||||||||||||.|||||||||.|||||||||||
|||||||||||. . . . .|||||||||||||.||||||||||||||||||||||||||||||||||||||||||||||||||||||.|||||||||||||. . . . . .|||||||||||
|||||||||||||||||.|||||||||||||||.||||||||||||||||||||||||||||||||||||||||||||||||||||||.|||||||||||||||.|||||||||||||||||||
|||||||||||||||||.|||||||||||||||.||||||||||||||||||||||||||||||||||||||||||||||||||||||.|||||||||||||||.|||||||||||||||||||
|||||||||||||||||*. . . . . . . . . .||||||||||||||||||||||||||||||||||||||||||||||||. . . . . . . . . .*|||||||||||||||||||
|||||||||||||||||||||||||||.||||||||. .||||||||||||||||||||||||||||||||||||||||||||. .||||||||.|||||||||||||||||||||||||||||
|||||||||||||||||||||||||||.||||||||||. .||||||||||||||||||||||||||||||||||||||||. .||||||||||.|||||||||||||||||||||||||||||
|||||||||||||||||||||||||||.||||||||||||. . . . . . . . . . .* . . . . . . . . . .||||||||||||.|||||||||||||||||||||||||||||
|||||||||||||||||. . . . . .||||||||||||.||||||||||||||||||||.|||||||||||||||||.||||||||||||||. . . . . .|||||||||||||||||||
|||||||||||||||||.||||||||||||||||||||||*||||||||||||||||||||.|||||||||||||||||*||||||||||||||||||||||||.|||||||||||||||||||
|||||||||||||||||. . . . . .||||||||||||.||||||||||||||||||||.|||||||||||||||||.||||||||||||||. . . . . .|||||||||||||||||||
|||||||||||||||||||||||||||.||||||||||||. . . . . . . . . . .* . . . . . . . . .||||||||||||||.|||||||||||||||||||||||||||||
|||||||||||||||||||||||||||.||||||||||. .|||||||||||||||||||| |||||||||||||||||. .||||||||||||.|||||||||||||||||||||||||||||
|||||||||||||||||||||||||||.||||||||. .|||||||||||||||||||||| |||||||||||||||||||. .||||||||||.|||||||||||||||||||||||||||||
|||||||||||||||||*. . . . . . . . . .|||||||  A                             |||||||. . . . . . . . . . .*|||||||||||||||||||
|||||||||||||||||.|||||||||||||||.||||||||||||||||||||||||||||||||||||||||||||||||||||||.|||||||||||||||.|||||||||||||||||||
|||||||||||||||||.|||||||||||||||.||||||||||||||||||||||||||||||||||||||||||||||||||||||.|||||||||||||||.|||||||||||||||||||
|||||||||||. . . . .|||||||||||||.||||||||||||||||||||||||||||||||||||||||||||||||||||||.|||||||||||||. . . . . .|||||||||||
|||||||||||.|||||||.|||||||||||||. . .  . . . . . . . . . .|||||. . .  . . . . . . . . . |||||||||||||.|||||||||.|||||||||||
|||||||||||.|||||||.||||||||||||| |||||||||.||||||||||||||.|||||.|||||||||||||.||||||||| |||||||||||||.|||||||||.|||||||||||
|||||||||||.|||||||. . . . . . . .|||||||||.||||||||||||||.|||||.|||||||||||||.|||||||||. . . . . . . .|||||||||.|||||||||||
|||||||||||.|||||||||||||||||||||||||||||||.||||||||||||||.|||||.|||||||||||||.|||||||||||||||||||||||||||||||||.|||||||||||
|||||||||||. . . . . . . . . . . . . . . . *||||||||||||||.|||||.|||||||||||||*. . . . . . . . . . . . . . . . . |||||||||||
|||||||||||.|||||||||||||||||||||||||||||||.||||||||||||||.|||||.|||||||||||||.|||||||||||||||||||||||||||||||||.|||||||||||
|||||||||||.|||||||||. . . . . . ||||||||||. . . . . . . . |||||. . . . . . . .||||||||||. . . . . . .||||||||||.|||||||||||
|||||||||||.||||||||| ||||||||||.||||||||||.||||||||||||||.  *  .|||||||||||||.||||||||||.|||||||||||.||||||||||.|||||||||||
|||||||||||. . . . . *||||||||||.||||||||||.||||||||||||||||||||||||||||||||||.||||||||||.|||||||||||*. . . . . .|||||||||||
||||||||||||||.|||||||||||||||||. . . . . . ||||||||||||||||||||||||||||||||||. . . . . . |||||||||||||||||||.||||||||||||||
||||||||||||||. . . . . . . . . .||||||||||||||||||||||||||||||||||||||||||||||||||||||||. . . . . . . . . . .||||||||||||||
||||||||||||||||||||||||||||||||||||||||||||||||||||||||||||||||||||||||||||||||||||||||||||||||||||||||||||||||||||||||||||
